6,3,3,3,3,3,3,3,5,7
6,3,3,3,3,3,3,2,0,0
6,3,3,3,3,3,3,3,3,7
8,4,4,2,0,1,3,3,3,7
8,8,8,6,3,3,3,3,3,7
3,3,3,3,3,3,3,2,0,0
3,3,3,3,3,3,3,3,3,7
3,3,3,3,3,2,0,0,1,7
2,0,0,1,3,3,3,3,3,7
4,4,4,4,4,4,4,4,4,4

1,0,0,0,0,0,0,0,0,1
1,0,0,0,0,0,0,1,1,1
1,0,0,0,0,0,0,0,0,1
1,1,1,1,1,1,0,0,0,1
1,1,1,1,0,0,0,0,0,1
0,0,0,0,0,0,0,1,1,1
0,0,0,0,0,0,0,0,0,1
0,0,0,0,0,1,1,1,1,1
1,1,1,1,0,0,0,0,0,1
1,1,1,1,1,1,1,1,1,1
